R 1080 720
SO ./textures/brickov.xpm
WE ./textures/gemov2.xpm
EA ./textures/gemov4.xpm
S ./textures/sprite_1.xpm
NO ./textures/orevein.xpm
C   112, 112,112
F 59, 56, 51



11111111111111111111111111111111
100000000000000000000000000000001
100000000000000000000000000000001
100200000000000000000000002000001
100000000000000000000000000000001
10S000000000000000000000000000001
100000000000002000000000000000001
100000000000000000000000000000001
1000000000000000000000000000000001
100000000000000000000000000000001
1000000200000000000000000000000001
100000000000000000000000000000001
100011111111100011111111111111111
100001      10001
1000001     10001  
10000001    10001
100000001   10001
100000001   10001
100000001   10001
100000001   10001
100000001   10001
1111100111110001
    100000000001
    111111111111
